NO         ./textures/deepslate_coal.png 
WE                                      ./textures/Gilded_Blackstone.png                                                                             

F 0,0,0
C 0,0,0


SO  ./textures/netherite.png  

EA ./textures/Stone_Bricks.png

1111111111111
1000000100001
100E000D00001
1000000101001
10001D1101001
1000000001001
1000000000001
1000000100001
1000011100001
1000000000001
1001000000001
1001000000M01
10000I0000001
1000000000001
1000000000001
1000001000001
100000D000101
10000010011D1
100000D000001
1000001000001
1000000000101
1000000100101
10M0000D00101
1000000100D01
1000000000101
10001100001D1
1000000000001
1111111111111