   11111111111111111
   10000000000000001
   10000000000000001
11110010001111110001
10000010001    11001
10000000001111110001
10000000000000010001
11110000000000011111
   1111111111111

