NO         ./textures/cat1.png                      
WE                                      ./textures/cat2.png                                                                             

F 15,150,55
C 140,40,20


SO  ./textures/cat3.png  

EA ./textures/cat4.png

   111111111
   10000000111111111111
   10110000000000000001
11110100010111111100001
100000000001     100001
100000S00001     100001
111100000001     1111111
   101000001
   1000000011111
   1000010000001
   1000000000011
   1111111111111