NO         ./textures/S.png                      
WE                                      ./textures/W.png                                                                             

F 15,150,55
C 140,40,20


SO  ./textures/N.png  

EA ./textures/E.png

1111111111111
1000000100001
1000000000001
1000N00001001
1000000001001
1000000000001
1000000100001
1000011100001
1000000000001
1111111111111