NO         ./textures/deepslate_coal.png 
WE                                      ./textures/Gilded_Blackstone.png                                                                             

F 0,0,0
C 0,0,0


SO  ./textures/netherite.png  

EA ./textures/Stone_Bricks.png

1111111111111
1000000100001
100E000D00001
1000000101001
10001D1101001
1000000001001
1000000000001
1000000100001
1000011100001
1000000000001
1000000000001
1000000000M01
10000I0000001
1000000000001
1000000000001
1000000000001
1000000000001
1000000000001
1000000000001
1000000000001
1000000000001
1000000100001
10M0000D00001
1000000100001
1000000000001
1000000000001
1000000000001
1111111111111