   111111111
   100000001
   101100001
111101000101
100000000001
100000000001
111100000001
   101000001
   1000000011111
   1000010000011
   1000000000011
   1111111111111
