NO         ./textures/deepslate_coal.png 
WE                                      ./textures/Gilded_Blackstone.png                                                                             

F 0,0,0
C 0,0,0


SO  ./textures/netherite.png  

EA ./textures/Stone_Bricks.png

  1111111111111111111
 11000001000000100001
110000000000000D00001
100000001000000101001
11D111111111D11010011
10001   10000000010001111111111
10I01   100000000000000000100I1
10001   1000M00100000000M0D0I01
10001   10000111000100000010I01
10001   10000000000111000111111
10N01   100100000001110011
10001   1001000000M0110011111
11111   10000I000000110010011
        10000000000011000I001
        100000000000110101011
        100000100000111111111
        100000D000101
        10000010011D1
        100000D000001
        1000001000001
        1000000000101
        1000000100101
        10M0000D00101
        1000000100D01
        1000000000101
        10001100001D1
        1000000000001
        1111111111111