NO         ./textures/cat1.png                      
WE                                      ./textures/cat2.png                                                                             

F 15,150,55
C 140,40,20


SO  ./textures/cat3.png  

EA ./textures/cat4.png

   111111111
   10000000111111111111
   10110I00D00000D00001
11110100000111111100M01
100M0000000D01   100001
100000W000011    100001
1111000I000     111111
   100000001
   1000100011111
   1000000000001
   100I0000M0011
   1111111111111