NO ./textures/fait_gaffe.png
SO ./textures/fait_gaffe.png
WE ./textures/fait_gaffe.png
EA ./textures/fait_gaffe.png

F 10,25,15
C 100,15,22

        11111111111111111111111111111111
        10000011000000000000111111111111
        10110000011100000000000000000111
        10010000000000000000000000000011
1111111110110000011100000000000011100011
100000000011000001110111111111111 100011
11110111111111011100000010001111  100011
1111011111111101110101000100000011110001
1100000011010101110000000000000000000111
100000000000000011000000000N100000001111
1000000000000000110101001000111111111111
1100000111010101111101111001111111111111
1111011111110101101111010001111111111111
1111111111111111111111111111111111111111
