                                
        1111111111111111111111111
        100000000011000000000000111111
        1011000001110000000000000000011
        1001000000000000000000000000001
111111111011000001110000000000001110001
100000000011000001110111111111111 10001
11110111111111011100000010001111  10001
111101111111110111010100100000011110001
110000001101010111000000000000000000011
10000000000000001100000000001000000011
1000000000000000110101001000111111111
11000001010101011111011110N0111
11110111 1110101 101111010001
11111111 1111111 111111111111
