NO ./textures/deepslate_coal.png
SO ./textures/Gilded_Blackstone.png
WE ./textures/netherite.png
EA ./textures/Stone_Bricks.png

F 10,50,5
C 100,10,0

        11111111111111111111111111111111
        10000011000000000000111111111111
        10110000011100000000000000000111
        10010000000000000000000000000011
1111111110110000011100000000000011100011
100000000011000001110111111111111 100011
11110111111111011100000010001111  100011
1111011111111101110101000100000011110001
1100000011010101110000000000000000000111
100000000000000011000000000N100000001111
1000000000000000110101001000111111111
11000001110101011111011110011
1111011111110101101111010001
1111111111111111111111111111
