NO ./textures/N.png
SO ./textures/S.png
WE ./textures/W.png
EA ./textures/E.png

F 10,25,15
C 255,255,255

        1111111111111111111111111
        100000110000000000001111111111
        1011000001110000000000000000011
        1001000000000000000000000000001
111111111011000001110000000000001110001
100000000011000001110111111111111 10001
11110111111111011100000010001111  10001
1111011111111101110101000100000011110001
110000001101010111000000000000000000011
100000000000000011000000000N1000000011
1000000000000000110101001000111111111
110000011101010111110111100111
11110111 1110101 101111010001
11111111 1111111 111111111111
